0 4 0 0 0 0 1 7 9
0 0 2 0 0 8 0 5 4
0 0 6 0 0 5 0 0 8
0 8 0 0 7 0 9 1 0
0 5 0 0 9 0 0 3 0
0 1 9 0 6 0 0 8 0
8 0 0 3 0 0 5 0 0
4 9 0 8 0 0 2 0 0
1 6 5 0 0 0 0 4 0

0 0 4 3 0 0 2 0 9
0 0 5 0 0 9 0 0 3
0 6 0 0 0 0 0 0 7
0 9 0 0 5 1 4 0 0
0 0 0 7 0 4 0 0 0
0 0 1 8 2 0 0 3 0
2 0 0 0 0 0 0 8 0
8 0 0 4 0 0 1 0 0
5 0 3 0 0 7 9 0 0

7 0 0 1 5 0 0 0 9
0 0 0 0 0 2 0 3 0
0 0 0 8 0 7 0 2 5
0 4 5 7 0 0 0 0 0
0 0 3 0 0 0 1 0 0
0 0 0 0 0 9 8 5 0
3 7 0 5 0 1 0 0 0
0 6 0 9 0 0 0 0 0
4 0 0 0 8 6 0 0 1

7 9 0 0 0 0 3 0 0
0 0 0 9 0 7 0 0 2
3 0 0 0 0 5 9 0 0
0 0 0 3 4 0 2 0 7
0 0 7 0 9 0 6 0 0
4 0 2 0 6 8 0 0 0
0 0 9 5 0 0 0 0 6
5 0 0 6 0 3 0 0 0
0 0 1 0 0 0 0 8 4

1 0 5 0 0 4 0 8 0
0 0 0 0 0 0 1 0 7
0 7 8 3 0 0 0 0 4
0 2 0 0 0 0 0 6 0
0 0 0 4 0 2 0 0 0
0 5 0 0 0 0 0 9 0
7 0 0 0 0 6 2 3 0
6 0 2 0 0 0 0 0 0
0 8 0 5 0 0 4 0 9