0 0 0 7 0 0 8 0 0
1 0 0 0 0 0 0 4 3
0 0 2 3 0 0 0 0 7
0 0 5 0 0 9 3 0 0
0 3 0 4 0 5 0 1 0
0 0 8 1 0 0 6 0 0
5 0 0 0 0 4 1 0 0
4 9 0 0 0 0 0 0 8
0 0 3 0 0 1 0 0 0

0 4 0 0 0 0 0 0 7
0 0 8 0 0 9 1 0 0
0 0 2 7 0 5 0 0 3
0 0 0 0 2 0 0 9 0
7 0 0 5 0 3 0 0 4
0 6 0 0 4 0 0 0 0
4 0 0 1 0 7 8 0 0
0 0 1 6 0 0 3 0 0
8 0 0 0 0 0 0 1 0

5 3 0 0 7 0 0 0 0
6 0 0 1 9 5 0 0 0
0 9 8 0 0 0 0 6 0
8 0 0 0 6 0 0 0 3
4 0 0 8 0 3 0 0 1
7 0 0 0 2 0 0 0 6
0 6 0 0 0 0 2 8 0
0 0 0 4 1 9 0 0 5
0 0 0 0 8 0 0 7 9

0 0 1 0 0 7 0 9 0
5 0 0 0 0 0 3 0 0
0 0 0 4 2 0 0 8 0
0 1 0 0 0 0 4 0 5
0 9 0 3 0 2 0 7 0
3 0 6 0 0 0 0 2 0
0 8 0 0 5 3 0 0 0
0 0 2 0 0 0 0 0 4
0 5 0 1 0 0 8 0 0

0 2 0 0 0 0 6 0 0
0 0 0 0 7 5 0 0 9
0 3 0 0 1 0 0 8 0
0 0 0 1 0 3 0 2 8
0 0 9 8 0 2 1 0 0
2 4 0 6 0 9 0 0 0
0 9 0 0 4 0 0 3 0
8 0 0 7 3 0 0 0 0
0 0 6 0 0 0 0 1 0