0 0 3 0 4 0 0 8 9
9 0 0 0 2 8 0 0 0
1 0 0 9 0 0 0 0 2
0 0 5 1 8 0 0 0 0
0 0 0 0 0 0 0 1 0
0 0 0 0 7 2 3 0 0
5 0 0 0 0 4 0 0 7
0 0 0 5 3 0 0 0 1
2 7 0 0 1 0 8 0 0

5 1 0 0 0 2 0 0 0
0 0 0 8 0 0 0 1 0
0 9 6 3 0 0 5 0 0
0 3 0 0 0 0 0 0 5
0 0 7 0 5 0 3 0 0
1 0 0 0 0 0 0 8 0
0 0 1 0 0 5 8 9 0
0 5 0 0 0 1 0 0 0
0 0 0 9 0 0 0 3 2

0 0 3 0 0 0 0 9 0
0 6 0 0 5 1 3 0 0
0 9 7 3 0 0 5 0 0
0 0 9 0 0 0 0 3 1
0 0 0 0 7 0 0 0 0
6 3 0 0 0 0 9 0 0
0 0 6 0 0 3 1 7 0
0 0 2 6 1 0 0 5 0
0 1 0 0 0 0 8 0 0

9 0 0 1 0 0 0 0 5
1 0 5 0 0 0 0 7 0
0 0 0 0 9 0 0 8 1
0 3 0 0 7 4 0 0 0
0 0 0 3 0 5 0 0 0
0 0 0 9 2 0 0 4 0
3 1 0 0 6 0 0 0 0
0 4 0 0 0 0 8 0 9
7 0 0 0 0 1 0 0 6

0 6 3 0 7 0 0 0 0
0 0 0 0 0 9 0 3 5
7 0 0 0 1 0 0 0 9
0 0 0 0 0 0 3 0 8
0 0 6 0 0 0 7 0 0
9 0 4 0 0 0 0 0 0
8 0 0 0 6 0 0 0 2
1 2 0 8 0 0 0 0 0
0 0 0 0 2 0 8 1 0
